0
0
0
0
0
0
0
0
0
0
0
0
0
0
0
0
0
0
0
0
0
0
0
00000000000000000000000000000000000000000122300000000000000000000000000000001300012222222222230000000000000000000000
00000000000000000000000000000000000012230000000000000000000000000000000001300000000000000000000000000000000002000000
00000122300000000000000000000000122300000000000000000122300000000000001300000000000000000000000000000000200205000000
00000455600000000123000000000000455600000000000000000455522230000000000000000000000000000000000000000000500505000000
22222555522222222555222222222222555522222222220000222555555552222222222222222222222222222222222222222222222222222222
55555555555555555555555555555555555555555555550000555555555555555555555555555555555555555555555555555555555555555555
55555555555555555555555555555555555555555555550000555555555555555555555555555555555555555555555555555555555555555555
55555555555555555555555555555555555555555555550000555555555555555555555555555555555555555555555555555555555555555555
55555555555555555555555555555555555555555555555555555555555555555555555555555555555555555555555555555555555555555555